14 14 14 14 14 14 14 14 14 14 14 14 14 14 14 14 14 14 14 14 14 14 14 14 14 14 14 14 14 14 14 14 14 14 14 14 14 14 14 14 14 14 14 14 14 14 14 14 14 14 
14 30 28 28 28 28 28 33 14 14 14 14 14 14 14 14 14 30 28 28 28 28 28 28 28 28 28 28 28 28 28 28 28 28 28 28 28 28 33 14 14 14 14 14 14 14 14 14 14 14 
14 29 38 38 38 38 38 36 14 14 14 14 14 14 14 14 14 29 38 38 38 38 38 38 38 38 38 38 38 38 38 38 38 38 38 38 38 38 36 14 14 14 14 14 14 14 14 14 14 14 
14 29 38 38 38 38 38 36 14 14 14 14 14 14 14 14 14 29 38 38 38 38 38 38 38 38 38 38 38 38 38 38 38 38 38 38 38 38 36 14 14 14 14 14 14 14 14 14 14 14 
14 29 38 38 38 38 38 36 14 14 14 14 14 14 14 14 14 29 38 38 38 38 38 38 38 38 38 38 38 38 38 38 38 38 38 38 38 38 36 14 14 14 14 14 14 14 14 14 14 14 
14 29 38 38 38 38 38 36 14 14 14 14 38 38 38 38 38 38 38 38 38 38 38 38 38 38 38 38 38 38 38 38 38 38 38 38 38 38 38 38 38 38 38 38 38 38 38 38 38 14 
14 29 38 38 38 38 38 36 14 14 14 14 38 14 14 14 14 29 38 38 38 38 38 38 38 38 38 38 38 38 38 38 38 38 38 38 38 38 36 14 14 14 14 14 14 14 29 38 36 14 
14 29 38 38 38 38 38 36 14 14 14 14 38 14 14 14 14 29 38 38 38 38 38 38 38 38 38 38 38 38 38 38 38 38 38 38 38 38 36 14 14 14 14 14 14 14 29 38 36 14 
14 29 38 38 38 38 38 36 14 14 14 14 38 14 14 14 14 29 38 38 38 38 38 38 38 38 38 38 38 38 38 38 38 38 38 38 38 38 36 14 14 14 14 14 14 14 29 38 36 14 
14 31 31 38 31 31 31 31 14 14 14 14 38 14 14 14 14 29 38 38 38 38 38 38 38 38 38 38 38 38 38 38 38 38 38 38 38 38 36 14 14 14 14 14 14 14 29 38 36 14 
14 14 14 38 14 14 14 14 14 14 14 14 38 14 14 14 14 29 38 38 38 38 38 38 38 38 38 38 38 38 38 38 38 38 38 38 38 38 36 14 14 14 14 14 14 14 29 38 36 14 
14 14 14 38 14 14 14 14 14 14 14 14 38 14 14 14 14 29 38 38 38 38 38 38 38 38 38 38 38 38 38 38 38 38 38 38 38 38 36 14 14 14 14 14 14 14 29 38 36 14 
14 14 14 38 38 38 38 38 38 38 38 38 38 14 14 14 14 29 38 38 38 38 38 38 38 38 38 38 38 38 38 38 38 38 38 38 38 38 36 14 14 14 14 14 14 14 29 38 36 14 
14 14 14 14 14 14 14 14 14 14 14 14 14 14 14 14 14 31 31 31 31 31 31 31 31 31 31 31 31 31 31 31 31 31 31 31 31 31 31 14 14 14 14 14 14 14 29 38 36 14 
14 14 14 14 14 14 14 14 14 14 14 14 14 14 14 14 14 14 14 14 14 14 14 14 14 14 14 14 14 14 14 14 14 14 14 14 14 14 14 14 14 14 14 14 14 14 29 38 36 14 
14 14 14 14 14 14 14 14 14 14 14 14 14 14 14 14 14 14 14 14 14 14 14 14 14 14 14 14 14 14 14 14 14 14 14 14 14 14 14 14 14 14 14 14 14 14 29 38 36 14 
14 14 14 14 14 14 14 14 14 14 14 14 14 14 14 14 14 14 14 14 14 14 14 14 14 14 14 14 14 14 14 14 14 14 14 14 14 14 14 14 14 14 14 14 14 14 29 38 36 14 
14 14 14 14 14 14 14 14 14 14 14 14 14 14 14 14 14 14 14 14 14 14 14 14 14 14 14 14 14 14 14 14 14 14 14 14 14 14 14 14 14 14 14 14 14 14 29 38 36 14 
14 14 14 14 14 14 14 14 14 14 14 14 14 14 14 14 14 14 14 14 14 14 14 14 14 14 14 14 14 14 14 14 14 14 14 14 14 14 14 14 14 14 14 14 14 14 29 38 36 14 
14 14 14 14 14 14 14 14 14 14 14 14 14 14 14 14 14 14 14 14 14 14 14 14 14 14 14 14 14 14 14 14 14 14 14 14 14 14 14 14 14 14 14 14 14 14 29 38 36 14 
14 14 14 14 14 14 14 14 14 14 14 14 14 14 14 14 14 14 14 14 14 14 14 14 14 14 14 14 14 14 14 14 14 14 14 14 14 14 14 14 14 14 14 14 14 14 29 38 36 14 
14 14 14 14 14 14 14 14 14 14 14 14 14 14 14 14 14 14 14 14 14 14 14 14 14 14 14 14 14 14 14 14 14 14 14 14 14 14 14 14 14 14 14 14 14 14 29 38 36 14 
14 14 14 14 14 14 14 14 14 14 14 14 14 14 14 14 14 14 14 14 14 14 14 14 14 14 14 14 14 14 14 14 14 14 14 14 14 14 14 14 14 14 14 14 14 14 29 38 36 14 
14 14 14 14 14 14 14 14 14 14 14 14 14 14 14 14 14 14 14 14 14 14 14 14 14 14 14 14 14 14 14 14 14 14 14 14 14 14 14 14 14 14 14 14 14 14 29 38 36 14 
14 14 14 14 14 14 14 14 14 30 28 28 28 28 28 28 33 14 14 14 14 14 14 14 14 14 14 14 14 14 14 14 14 14 14 14 14 14 14 14 14 14 14 14 14 14 29 38 36 14 
14 28 28 28 28 28 28 28 28 38 38 38 38 38 38 38 36 14 14 14 14 14 14 14 14 14 14 14 14 14 14 14 14 14 14 14 14 14 14 14 14 14 14 14 14 14 29 38 36 14 
14 38 38 38 38 38 38 38 38 38 38 38 38 38 38 38 38 33 14 14 14 14 14 14 14 14 14 14 14 14 14 14 14 14 14 14 14 14 14 14 14 14 14 14 14 14 29 38 36 14 
14 38 38 38 38 38 38 38 38 38 38 38 38 38 38 38 38 38 28 28 28 28 28 28 28 28 33 14 14 14 14 14 14 14 14 14 14 14 14 14 14 14 14 14 14 14 29 38 36 14 
14 31 31 31 31 31 31 31 31 38 38 38 38 38 38 38 38 38 38 38 38 38 38 38 38 38 38 33 14 14 14 14 14 14 14 14 14 14 14 14 14 14 14 14 14 14 29 38 36 14 
14 14 14 14 14 14 14 14 14 29 38 38 38 38 38 38 38 38 38 38 38 38 38 38 38 38 38 38 33 14 14 14 14 14 14 14 14 14 14 14 14 14 14 14 14 14 29 38 36 14 
14 14 14 14 14 14 14 14 14 29 38 38 38 38 38 38 38 31 31 31 31 31 31 31 31 38 38 38 36 14 14 14 14 14 14 14 14 14 14 14 14 14 14 14 14 14 29 38 36 14 
14 14 14 14 14 14 14 14 14 31 31 31 31 31 31 31 31 14 14 14 14 14 14 14 14 31 29 38 36 14 14 14 14 14 14 14 14 14 14 14 14 14 14 14 14 14 29 38 36 14 
14 14 14 14 14 14 14 14 14 14 14 14 14 14 14 14 14 14 14 14 14 14 14 14 14 14 29 38 36 14 14 14 14 14 14 14 14 14 14 14 14 14 14 14 14 14 29 38 36 14 
14 14 14 14 14 14 14 14 14 14 14 14 14 14 14 14 14 14 14 14 14 14 14 14 14 14 29 38 36 14 14 14 14 14 14 14 14 14 14 14 14 14 14 14 14 14 29 38 36 14 
14 14 14 14 14 14 14 14 14 14 14 14 14 14 14 14 14 14 14 14 14 14 14 14 14 14 29 38 36 14 14 14 14 14 14 14 14 14 14 14 14 14 14 14 14 14 29 38 36 14 
14 14 14 14 14 14 14 14 14 14 14 14 14 14 14 14 14 14 14 14 14 14 14 14 14 14 29 38 36 14 14 14 14 14 14 14 14 14 14 14 14 14 14 14 30 28 38 38 36 14 
14 14 14 14 14 14 14 14 14 14 14 14 14 14 14 14 14 14 14 14 14 14 14 14 14 14 29 38 36 14 14 14 14 14 14 14 14 14 14 14 14 14 14 14 29 38 38 38 36 14 
14 14 14 14 14 14 14 14 14 14 14 14 14 14 14 14 14 14 14 14 14 14 14 14 14 14 29 38 36 14 14 14 14 14 14 14 14 14 14 14 14 14 14 14 29 38 38 38 36 14 
14 14 14 14 14 14 14 14 14 14 14 14 14 14 14 14 14 14 14 14 14 14 14 14 14 14 29 38 36 14 14 14 14 14 14 14 14 14 14 14 14 14 14 14 29 38 38 31 31 14 
14 14 14 14 14 14 14 14 14 14 14 14 14 14 14 14 14 14 14 14 14 14 14 14 14 14 29 38 36 14 14 14 14 14 14 14 14 14 14 14 14 14 14 14 29 38 36 14 14 14 
14 14 14 14 14 14 14 14 14 14 14 14 14 14 14 14 14 14 14 14 14 14 14 14 14 14 29 38 36 14 14 14 14 14 14 14 14 14 14 14 14 14 14 14 29 38 36 14 14 14 
14 14 14 14 14 14 14 14 14 14 14 14 14 14 14 14 14 14 14 14 14 14 14 14 14 14 29 38 36 14 14 14 14 14 14 14 14 14 14 14 14 14 14 14 29 38 36 14 14 14 
14 14 14 14 14 14 14 14 14 14 14 14 14 14 14 14 14 14 14 14 14 14 14 14 14 14 29 38 36 14 14 14 14 14 14 14 14 14 14 14 14 14 14 14 29 38 36 14 14 14 
14 14 14 14 14 14 14 14 14 14 14 14 14 14 14 14 14 14 14 14 14 14 14 14 14 14 29 38 38 28 28 28 28 28 28 28 28 28 28 28 28 28 28 28 38 38 36 14 14 14 
14 14 14 14 14 14 14 14 14 14 14 14 14 14 14 14 14 14 14 14 14 14 14 14 14 14 29 38 38 38 38 38 38 38 38 38 38 38 38 38 38 38 38 38 38 38 36 14 14 14 
14 14 14 14 14 14 14 14 14 14 14 14 14 14 14 14 14 14 14 14 14 14 14 14 14 14 29 38 38 38 38 38 38 38 38 38 38 38 38 38 38 38 38 38 38 38 36 14 14 14 
14 14 14 14 14 14 14 14 14 14 14 14 14 14 14 14 14 14 14 14 14 14 14 14 14 14 31 31 31 31 31 31 31 31 31 31 31 31 31 31 31 31 31 31 31 31 31 14 14 14 
14 14 14 14 14 14 14 14 14 14 14 14 14 14 14 14 14 14 14 14 14 14 14 14 14 14 14 14 14 14 14 14 14 14 14 14 14 14 14 14 14 14 14 14 14 14 14 14 14 14 
14 14 14 14 14 14 14 14 14 14 14 14 14 14 14 14 14 14 14 14 14 14 14 14 14 14 14 14 14 14 14 14 14 14 14 14 14 14 14 14 14 14 14 14 14 14 14 14 14 14 
14 14 14 14 14 14 14 14 14 14 14 14 14 14 14 14 14 14 14 14 14 14 14 14 14 14 14 14 14 14 14 14 14 14 14 14 14 14 14 14 14 14 14 14 14 14 14 14 14 14 
