11111111111111111111111111111111111111111111111111
10000000000000000000000000000000000000000000000001
10000020003000000000000000000000000000000000000001
10000020000000011111100000000000000000000000000001
10000020003000014444100000000000000000000000000001
10000020000000014444100000000000000000000000000001
10000020000033011141100000000000000000000000000001
10000020000000000003003300000000000000000000000001
10000022222222222222222222222220000000000000000001
10000000000000000000000000000020000000000000000001
10000000000300000033000000000020033000000000000001
10000000000000000000000000000020000033000000000001
10000000000000000000000000330020000003000000000001
10000000000000000000000330000020000000000000000001
10000000000000000000000000330020000300000000000001
10000000000000033003000000000020030000000000000001
10000030003300000000333000000020030000000000000001
12222222222222222222222222222222222222222222222221
10300003000000030003300000000020000000300000300001
10000003300000000000000330000020000000000000000001
10000000000000000000000000000020000000000000000001
10000000000000000000000000000020000000000000000001
10000000000000000000000000000020000000000000000001
10000000000000000000000000000020000000000000000001
11111111111111111111111111111111111111111111111111
